32 22
1 1 1 1 1 1 1 1 1 1 1 1 1 1 1 1 1 1 1 1 86 86 86 115 116 117 86 86 86 109 1 1 
1 1 1 1 1 1 1 1 1 1 1 31 32 1 1 1 1 1 1 1 148 86 148 149 3 150 148 86 148 1 1 1 
1 1 1 31 32 31 32 1 1 31 86 86 86 32 1 1 1 1 1 1 86 148 86 406 406 148 86 148 86 1 1 1 
1 1 31 86 86 86 86 32 31 86 86 86 86 86 32 1 1 1 1 1 86 86 86 86 406 86 406 86 86 435 1 1 
1 31 86 86 406 86 86 86 86 86 86 86 86 86 86 86 86 86 32 31 86 86 86 86 86 86 86 86 86 86 435 1 
1 86 86 111 86 86 86 86 86 86 406 86 86 86 406 86 86 86 86 86 86 86 86 86 86 86 406 86 86 86 86 1 
1 110 86 111 111 86 86 406 86 86 86 86 86 86 86 109 110 86 86 86 86 406 86 86 86 86 86 373 374 86 109 1 
1 1 86 86 86 86 86 86 86 86 86 406 86 86 109 1 1 110 86 86 86 86 86 86 86 86 86 378 379 86 1 1 
1 1 86 86 86 86 86 86 86 86 86 86 86 109 1 1 1 1 110 86 86 86 86 86 406 86 86 86 86 86 1 1 
1 1 219 219 219 219 110 86 86 86 109 219 219 1 1 1 1 1 219 219 219 219 219 219 219 219 219 219 219 219 1 1 
1 1 1 1 1 1 1 86 406 86 1 1 1 1 1 1 1 1 1 1 1 1 1 1 1 1 1 1 1 1 1 1 
432 432 432 432 432 432 432 86 86 86 432 432 432 432 432 432 432 432 432 432 432 432 432 432 432 432 432 432 432 432 432 432 
432 432 432 432 432 432 434 86 406 86 432 432 432 432 432 432 432 432 432 432 432 432 434 86 86 86 86 86 86 86 86 432 
432 432 432 434 86 86 86 86 86 86 432 432 432 432 432 432 432 432 432 432 432 434 86 86 406 86 453 432 432 432 86 432 
432 432 434 86 86 406 86 86 86 86 432 432 432 432 432 432 432 432 432 432 434 86 86 86 86 86 432 432 86 86 86 432 
432 434 86 86 86 86 86 86 86 86 435 432 432 432 432 432 432 432 432 434 86 86 86 375 376 86 435 432 432 432 432 432 
432 86 86 86 86 86 86 86 86 86 86 86 86 86 86 406 86 86 86 86 86 86 406 381 382 86 86 86 439 424 425 432 
432 452 86 86 86 86 86 86 86 86 86 86 406 86 86 86 86 86 86 86 406 86 86 86 86 439 424 424 426 426 451 432 
432 432 86 86 86 86 86 86 86 86 86 86 86 86 453 456 456 452 86 86 86 375 376 86 86 443 426 426 426 427 86 432 
432 432 86 86 86 86 86 86 453 456 452 86 86 86 432 432 432 432 86 86 86 381 382 412 412 449 450 450 450 451 453 432 
432 432 456 456 456 456 456 456 432 432 432 456 456 456 432 432 432 432 456 456 456 456 456 456 456 456 456 456 456 456 432 432 
432 432 432 432 432 432 432 432 432 432 432 432 432 432 432 432 432 432 432 432 432 432 432 432 432 432 432 432 432 432 432 432

