32 22
61  61  61  61  61  61  61  61  61  61  61  61  61  61  61  61  61  61  61  61  61  61  61  61  61  61  61  61  61  61  61  61
61  61  61  61  22  61  62   2   2   2  61  61  61  61  61  61  61  61  61  61  61  61  61   2   2   2  61  61  61  61  61  61
61  61  61  62   2   2   2   2   2   2  61  61  61  61  61  61  61  61  61  61  61   2   2   2   2   2  61  61  61  61  61  61
61  61  62   2   2   2   2   2   2   2  61  61  61  61  61  61  61  61  61  61  61   2   2   2   2   2  61  61  61  61  61  61
61  62   2   2   2   2   2   2   2   2  60  61  61  61  61  61  61  61  61  61   2   2   2   2   2   2  61  61  61  61  61  61
61   2   2   2   2   2   2   2   2   2   2   2   2   2   2   2   2   2   2   2   2   2   2   2   2   2   2   2   2   2   2  61
61  44   2   2   2   2   2   2   2   2   2   2   2   2   2   2   2   2   2   2   2   2   2   2   2   2   2   2   2   2  61  61
61  61   2   2   2   2   2   2   2   2   2   2   2   2  61  61  61  61   2   2   2   2   2   2   2   2   2   2   2   2  61  61
61  61   2   2   2   2   2   2   2   2   2   2   2   2  61  61  61  61   2   2   2   2   2   2   2   2   2   2   2   2  61  61
61  61  43  43  43  43  43   2   2   2  43  43  43  61  61  61  61  61  43  43  43  43  43  43  43  43  43  43  43  43  61  61
61  61  61  61  61  61  61   2   2   2  61  61  61  61  61  61  61  61  61  61  61  61  61  61  61  61  61  61  61  61  61  61
61  61  61  61  61  61  61   2   2   2  61  61  61  61  61  61  61  61  61  61  61  61  61  61  61  61  61  61  61  61  61  61
61  61  61  61  22  61  62   2   2   2  61  61  61  61  61  61  61  61  61  61  61  61  61   2   2   2  61  61  61  61  61  61
61  61  61  62   2   2   2   2   2   2  61  61  61  61  61  61  61  61  61  61  61   2   2   2   2   2  61  61  61  61  61  61
61  61  62   2   2   2   2   2   2   2  61  61  61  61  61  61  61  61  61  61  61   2   2   2   2   2  61  61  61  61  61  61
61  62   2   2   2   2   2   2   2   2  60  61  61  61  61  61  61  61  61  61   2   2   2   2   2   2  61  61  61  61  61  61
61   2   2   2   2   2   2   2   2   2   2   2   2   2   2   2   2   2   2   2   2   2   2   2   2   2   2   2   2   2   2  61
61  44   2   2   2   2   2   2   2   2   2   2   2   2   2   2   2   2   2   2   2   2   2   2   2   2   2   2   2   2  61  61
61  61   2   2   2   2   2   2   2   2   2   2   2   2  61  61  61  61   2   2   2   2   2   2   2   2   2   2   2   2  61  61
61  61   2   2   2   2   2   2   2   2   2   2   2   2  61  61  61  61   2   2   2   2   2   2   2   2   2   2   2   2  61  61
61  61  43  43  43  43  43  43  43  43  43  43  43  61  61  61  61  61  43  43  43  43  43  43  43  43  43  43  43  43  61  61
61  61  61  61  61  61  61  61  61  61  61  61  61  61  61  61  61  61  61  61  61  61  61  61  61  61  61  61  61  61  61  61
