11111111111111111111111111111111111111111111111111111111111111111111111111111111
11                                    1111                                    11
11                                    1111                                    11
11                                    1111                                    11
11                                    1111                                    11
11                                    1111                                    11
11                                    1111                                    11
1111   11111   1   1   111111     1111111111   11111   1   1   111111       1111
11           1 1 1 1 1                1111           1 1 1 1 1                11
11                                                                            11
11                                                                            11
11                                    1111                                    11
1111   1111   33   44   11111     1111111111   1111   33   44   11111       1111
11                                    1111                                    11
11                                    1111                                    11
11              111                   1111              111                   11
11                                    1111                                    11
1111   111  22       22  1111     1111111111   111  22       22  1111       1111
11            22   22                 1111            22   22                 11
11             22222                  1111             22222                  11
11                                    1111                                    11
11                                    1111                                    11
1111   1111111111111111111111     1111111111   1111111111111111111111       1111
11                                    1111                                    11
11                                    1111                                    11
11                                    1111                                    11
11                                    1111                                    11
11                                    1111                                    11
11                                    1111                                    11
111111111111111    11111111111  11111111                                      11
111111111111111    11111111111  11111111                                      11
11                                    11                                      11
11                                    11                                      11
11                                    11                                      11
11                                    11                                      11
11                                    11                                      11
1111   11111   1   1   111111     111111                                      11
11           1 1 1 1 1                11                                      11
11                                                                            11
11                                                                            11
11                                    11                                      11
1111   1111   33   44   11111     111111                                      11
11                                    11                                      11
11                                    11                                      11
11              111                   11                                      11
11                                    11                                      11
1111   111  22       22  1111     111111                                      11
11            22   22                 11                                      11
11             22222                  11                                      11
11                                    11                                      11
11                                    11                                      11
1111   1111111111111111111111     111111                                      11
11                                    11                                      11
11                                    11                                      11
11                                    11                                      11
11                                    11                                      11
11                                    11                                      11
11                                    11                                      11
11                                    11                                      11
11111111111111111111111111111111111111111111111111111111111111111111111111111111
