32 22
432 432 432 432 432 432 432 432 432 432 432 432 432 432 432 432 432 432 432 432 432 432 432 432 432 432 432 432 432 432 432 432
432 432 432 432 432 432 434 86 86 86 432 432 432 432 432 432 432 432 432 432 432 3 434 86 86 86 435 432 432 432 432 432
432 432 432 434 86 86 86 86 86 86 432 432 432 432 432 432 432 432 432 432 432 86 86 86 86 86 86 86 86 432 432 432
432 432 434 86 86 86 86 86 86 86 432 432 432 432 432 432 432 432 432 432 434 86 86 86 86 86 86 86 86 435 432 432
432 434 86 86 86 86 86 86 86 86 435 432 432 432 432 432 432 432 432 434 86 86 86 86 86 86 86 86 86 86 435 432
432 86 86 86 86 86 86 86 86 86 86 86 86 86 86 86 86 86 86 86 86 86 86 86 86 86 86 86 86 86 86 432
432 452 86 86 86 86 86 86 86 86 86 86 86 86 86 86 86 86 86 86 86 86 86 86 86 86 86 86 86 86 453 432
432 432 86 86 86 86 86 86 86 86 86 86 86 86 453 432 432 452 86 86 86 86 86 86 86 86 86 86 86 86 432 432
432 432 86 86 86 86 86 86 86 86 86 86 86 86 432 432 432 432 86 86 86 86 86 86 86 86 86 86 86 86 432 432
432 432 456 456 456 456 452 86 86 86 453 456 456 432 432 432 432 432 456 456 456 456 456 456 456 456 456 456 456 456 432 432
432 432 432 432 432 432 432 86 86 86 432 432 432 432 432 432 432 432 432 432 432 432 432 432 432 432 432 432 432 432 432 432
432 432 432 432 432 432 432 86 86 86 432 432 432 432 432 432 432 432 432 432 432 432 432 432 432 432 432 432 432 432 432 432
432 432 432 432 432 432 434 86 86 86 432 432 432 432 432 432 432 432 432 432 432 432 434 86 86 86 432 432 432 432 432 432
432 432 432 434 86 86 86 86 86 86 432 432 432 432 432 432 432 432 432 432 432 86 86 86 86 86 432 432 432 432 432 432
432 432 434 86 86 86 86 86 86 86 432 432 432 432 432 432 432 432 432 432 434 86 86 86 86 86 432 432 432 432 432 432
432 434 86 86 86 86 86 86 86 86 435 432 432 432 432 432 432 432 432 434 86 86 86 86 86 86 435 432 432 432 432 432
432 86 86 86 86 86 86 86 86 86 86 86 86 86 86 86 86 86 86 86 86 86 86 86 86 86 86 86 86 86 86 432
432 452 86 86 86 86 86 86 86 86 86 86 86 86 86 86 86 86 86 86 86 86 86 86 86 86 86 86 86 86 453 432
432 432 86 86 86 86 86 86 86 86 86 86 86 86 453 432 432 452 86 86 86 86 86 86 86 86 86 86 86 86 432 432
432 432 86 86 86 86 86 86 86 86 86 86 86 86 432 432 432 432 86 86 86 86 86 86 86 86 86 86 86 86 432 432
432 432 456 456 456 456 456 456 456 456 456 456 456 432 432 432 432 432 456 456 456 456 456 456 456 456 456 456 456 456 432 432
432 432 432 432 432 432 432 432 432 432 432 432 432 432 432 432 432 432 432 432 432 432 432 432 432 432 432 432 432 432 432 432
