32 22
55  55  55  55  55  55  55   2   2   2  55  55  55  55  55  55  55  55  55  55  55  55  55   2   2   2  55  55  55  55  55  55
55  55  55  55  22  55  62   2   2   2  55  55  55  55  55  55  55  55  55  55  55  55  55   2   2   2  55  55  55  55  55  55
55  55  55  62   2   2   2   2   2   2  55  55  55  55  55  55  55  55  55  55  55   2   2   2   2   2  55  55  55  55  55  55
55  55  62   2   2   2   2   2   2   2  55  55  55  55  55  55  55  55  55  55  55   2   2   2   2   2  55  55  55  55  55  55
55  62   2   2   2   2   2   2   2   2  60  55  55  55  55  55  55  55  55  55   2   2   2   2   2   2  55  55  55  55  55  55
55   2   2   2   2   2   2   2   2   2   2   2   2   2   2   2   2   2   2   2   2   2   2   2   2   2   2   2   2   2   2  55
55  44   2   2   2   2   2   2   2   2   2   2   2   2   2   2   2   2   2   2   2   2   2   2   2   2   2   2   2   2  55  55
55  55   2   2   2   2   2   2   2   2   2   2   2   2  55  55  55  55   2   2   2   2   2   2   2   2   2   2   2   2  55  55
55  55   2   2   2   2   2   2   2   2   2   2   2   2  55  55  55  55   2   2   2   2   2   2   2   2   2   2   2   2  55  55
55  55  43  43  43  43  43   2   2   2  43  43  43  55  55  55  55  55  43  43  43  43  43  43  43  43  43  43  43  43  55  55
55  55  55  55  55  55  55   2   2   2  55  55  55  55  55  55  55  55  55  55  55  55  55  55  55  55  55  55  55  55  55  55
55  55  55  55  55  55  55   2   2   2  55  55  55  55  55  55  55  55  55  55  55  55  55   2   2   2  55  55  55  55  55  55
55  55  55  55  22  55  62   2   2   2  55  55  55  55  55  55  55  55  55  55  55  55  55   2   2   2  55  55  55  55  55  55
55  55  55  62   2   2   2   2   2   2  55  55  55  55  55  55  55  55  55  55  55   2   2   2   2   2  55  55  55  55  55  55
55  55  62   2   2   2   2   2   2   2  55  55  55  55  55  55  55  55  55  55  55   2   2   2   2   2  55  55  55  55  55  55
55  62   2   2   2   2   2   2   2   2  60  55  55  55  55  55  55  55  55  55   2   2   2   2   2   2  55  55  55  55  55  55
55   2   2   2   2   2   2   2   2   2   2   2   2   2   2   2   2   2   2   2   2   2   2   2   2   2   2   2   2   2   2  55
55  44   2   2   2   2   2   2   2   2   2   2   2   2   2   2   2   2   2   2   2   2   2   2   2   2   2   2   2   2  55  55
55  55   2   2   2   2   2   2   2   2   2   2   2   2  55  55  55  55   2   2   2   2   2   2   2   2   2   2   2   2  55  55
55  55   2   2   2   2   2   2   2   2   2   2   2   2  55  55  55  55   2   2   2   2   2   2   2   2   2   2   2   2  55  55
55  55  43  43  43  43  43  43  43  43  43  43  43  55  55  55  55  55  43  43  43  43  43  43  43  43  43  43  43  43  55  55
55  55  55  55  55  55  55  55  55  55  55  55  55  55  55  55  55  55  55  55  55  55  55  55  55  55  55  55  55  55  55  55
