32 22
4 5 6 5 5 7 8 5 5 9 10 5 5 11 5 12 4 5 6 5 5 7 8 5 5 9 10 5 5 11 5 12
41 42 43 44 45 46 47 48 48 49 50 51 52 53 54 55 41 42 43 44 45 46 47 48 48 49 50 51 52 53 54 55
41 99 100 100 100 100 100 100 100 100 100 100 100 100 101 55 41 99 100 100 100 100 100 100 100 100 100 100 100 100 101 55
131 132 100 100 100 100 100 100 100 100 100 100 100 100 134 135 131 132 100 100 100 100 100 100 100 100 100 100 100 100 134 135
163 164 100 100 100 100 100 100 100 100 100 100 100 100 165 166 167 168 100 100 100 100 100 100 100 100 100 100 100 100 169 170
41 199 100 100 100 100 100 100 100 100 100 100 100 100 201 202 203 204 100 100 100 100 100 100 100 100 100 100 100 100 205 55
232 233 100 100 100 100 100 100 100 100 100 100 100 100 234 235 236 237 100 100 100 100 100 100 100 100 100 100 100 100 238 239
270 271 100 100 100 100 100 100 100 100 100 100 100 100 272 273 270 271 100 100 100 100 100 100 100 100 100 100 100 100 272 273
41 282 100 100 100 100 100 100 100 100 100 100 100 100 283 55 41 282 100 100 100 100 100 100 100 100 100 100 100 100 283 55
41 288 289 290 291 292 293 294 294 295 296 297 298 299 300 55 41 288 289 290 291 292 293 389 390 295 296 297 298 299 300 55
333 334 335 334 334 336 337 334 334 338 339 334 334 340 334 341 333 334 335 334 334 336 337 342 342 338 339 334 334 340 334 341
4 5 6 5 5 7 8 5 5 9 10 5 5 11 5 12 4 5 6 5 5 7 8 364 364 9 10 5 5 11 5 12
41 42 43 44 45 46 47 48 48 49 50 51 52 53 54 55 41 42 43 44 45 46 47 398 399 49 50 51 52 53 54 55
41 99 100 100 100 100 100 100 100 100 100 100 100 100 101 55 41 99 100 100 100 100 100 100 100 100 100 100 100 100 101 55
131 132 100 100 100 100 100 100 100 100 100 100 100 100 134 135 131 132 100 100 100 100 100 100 100 100 100 100 100 100 134 135
163 164 100 100 100 100 100 100 100 100 100 100 100 100 165 166 167 168 100 100 100 100 100 100 100 100 100 100 100 100 169 170
41 199 100 100 100 100 100 100 100 100 100 100 100 100 201 202 203 204 100 100 100 100 100 100 100 100 100 100 100 100 205 55
232 233 100 100 100 100 100 100 100 100 100 100 100 100 234 235 236 237 100 100 100 100 100 100 100 100 100 100 100 100 238 239
270 271 100 100 100 100 100 100 100 100 100 100 100 100 272 273 270 271 100 100 100 100 100 100 100 100 100 100 100 100 272 273
41 282 100 100 100 100 100 100 100 100 100 100 100 100 283 55 41 282 100 100 100 100 100 100 100 100 100 100 100 100 283 55
41 288 289 290 291 292 293 389 390 295 296 297 298 299 300 55 41 288 289 290 291 292 293 294 294 295 296 297 298 299 300 55
333 334 335 334 334 336 337 342 342 338 339 334 334 340 334 341 333 334 335 334 334 336 337 334 334 338 339 334 334 340 334 341